10 1 9
XXXXXXXXXX
X   XX   X
X XXXX XXX
X    X    
X XXXX X X
X      X X
XXX XX X X
XX   X XXX
X  X X   X
X XXXXXXXX
