10 1 9
XXXXXXXXXX
X   XX   X
XXXXXXXXXX
X    X    
XXXXXX XXX
XXX    X X
XXX XXXX X
XX  XX XXX
X  X X   X
X XXXXXXXX