20 1 19
XXXXXXXXXXXXXXXXXXXX
X   XX   X X       X
XXXXXXXXXXXX XXXXXXX
X    X           XXX
XXXXXX XXX XXXXXXXXX
XXX    X   XXXXXXXXX
XXX XXXX X XX XXX XX
XX  XX XXX XX XXX   
X  X X   X        XX
X XXXXXXXXXXXXXXXXXX
X                  X
X XXXXXXXXXXXXXXXXXX
X       XXXXXXXXXXXX
X XXXXX XXXXXXXXXXXX
X XX         XXXXXXX
X XXXXXXXXXX        
X XXXXXXXXXXXXXXXXXX
X X       XXXXXXXXXX
X   XXXXX          X
X XXXXXXXXXXXXXXXXXX