20 1 19
XXXXXXXXXXXXXXXXXXXX
X X X X X X X X X  X
X                 XX
X XXXXXXXXXXXXXXXXXX
X X X X X X X X X  X
X X X X X X X X X XX
X                   
X XXXXXXXXXXXXXXXXXX
X X X X X X X X X  X
X X X X X X X X X XX
X                  X
X XXXXXXXXXXXXXXXXXX
X X X X X X X X X  X
X X X X X X X X X XX
X                   
X XXXXXXXXXXXXXXXXXX
X X X X X X X X X  X
X X X X X X X X X XX
X                  X
X XXXXXXXXXXXXXXXXXX